NO ./pics/cross
WE ./pics/metal
EA ./pics/hitler
F 255,0,0
R 1920 1080


SO ./pics/verboten
S ./pics/hitler
C 0,0,255


 1111111111111111111111111   11111111       1111
1000000000000000000000001111
1000000000000000000000001111
1000222222222222222222221111
1000000000000000000000001111
1000000N00000000000000001111
1000000000000000000000001111
1000000000000000000000001111
1000000000000000000000001111
1000000000000000000000001111
1000000000000000000000001111
1000000000000000000000001111
 1111111111111111111111111   11111111       1111
