NO ./pics/cr
WE ./pics/metal
EA ./pics/hitler
F         255,0,0
R -1 000001080


SO ./pics/verboten
S ./pics/knight
C 0,0,255


 11111111111111111111111111   11111111       1111
10000000001100N00000000011              1111100001111
101100000111000000000001101                  11111
100100000000000000000000111111111
111111111011000001110000000000001
100000000011000001110111111111111
 11111111111111111111111111   11111111       1111
 111111111111111111111111111  11111111       1111
11110111111111011100000010001
11110111111111011101010010001
11000000110101011100000010001
10000000000000001100000010001
10000000000000001101010010001
112000011101010111110111100111
11110111 1110101 101111010001
11111111 1111111 111111111111
