NO ./pics/sample
WE ./pics/metal
EA ./pics/hitler
F 205,9,0
R 1920 1080


SO ./pics/verboten
S ./pics/knight
C 99,0,105


 1111111111111111111111111   11111111       1111
1000000000000000000000001111
1000222222222222222222201111
1000222222222222222222201111
1000000000000000000000001111
1000222222222222222220201111
1000000N00000000000000001111
1000222222222222222222201111
1000000000000000000000001111
1000222222222222222222201111
1000000000000000000000001111
1000222222222222222222221111
1000000000000000000000001111
1000222222222222222220201111
1000000000000000000000001111
1000222222222222222222201111
1000000000000000000000001111
1000222222222222222222201111
1000000000000000000000001111
1000222222222222222222201111
 1111111111111111111111111   11111111       1111
